wwwwwwwwwww          wwwwwwwwwwwwwwwwwwwwww      wwwwwwwwwwwwwwwwwwwwwwww
w    p    w          w          e         wwwwwwww                    e w
w         w          w                                                  w
w         w          w                                                  w
w         w          w                                                  w
w         w          w                    wwwwwwwwwwwwwwwwwww           w
www     www          wwwwwww        wwwwwww                 w           w
  w     w                  w        w                 wwwwwww           w
  w     w                  w        w                 w                 w
  w     wwwwwwwwwwwwwwwwwwww        wwwwwwwwwwwwwwwwwww                 w
  w                                         e                           w
  w                                                                     w
  w                                                                     w
  w            e                                                      e w
  wwwwwwwwwwwwwwwwwwwwwwwwwww        wwwwwwwwwwwwwwwwwwwwwwwwwwwwwwwwwwww
                            w        w
                            w        w
                            w        w
                            w        w
                   wwwwwwwwww        wwwwwwwwwwwwwwwwwwwwwwwwwwwwwwwww
                   w e                                               w
                   w                                                 d
                   w                                                 w
                   w                             wwwwwwwwwwwwwwwwwwwww
                   w                           e w
                   wwwwwwwwwwwwwwwwwwwwwwwwwwwwwww