wwwwwwwwwwwwww
w     p      w
w            w
w            w
w            w
w     e      w
w            w
w            w
wwwwwwdwwwwwww